#####################
####################2
#######4############2
####################2
####################2
#####2##############2
####################2
##5#################2
#######3############2
####################2
####################2
####################2
####################2
####################2
####################2
#22222222222222222222
